000000000000000000000000000000000000000000
000000000000000000000000000000000000000000
000000000000000000000000000000000000000000
000000000000000000000000000000000000000000
000000000000000000000000000002111120000000
000000021112000000000000000001111110000000
000000011111000000000000000002111110000000
000000021112000000000000000000001110000000
000000000000000000000000000000002120000000
000000000000000000000000000000000000000000
000000000000000000000000000000000000000000
000000000000000000000000000000000000000000
000000000000000000000000000000000000000000